00 00 00 00 00 00 00 00
00 00 00 00 00 00 00 00
00 00 00 00 00 00 00 00
00 00 00 00 00 00 00 00
00 00 00 00 00 00 00 00

63 22 40 00 00 00 00 00
6e 21 40 00 00 00 00 00
4f 21 40 00 00 00 00 00
48 00 00 00 00 00 00 00
42 22 40 00 00 00 00 00
e1 21 40 00 00 00 00 00
2f 22 40 00 00 00 00 00
a8 21 40 00 00 00 00 00
6e 21 40 00 00 00 00 00
9a 20 40 00 00 00 00 00
37 64 33 38 35 32 61 62
00

